DUMB MAP
W=10
H=10
M{
##########
#////////#
#////////#
#////////#
####*#####
####*#####
#////////#
#////////#
#///@////#
##########
F{
0000000000
0101001000
0000000000
0000000000
0000000000
0000000000
0000000000
0000000000
0000000000
0000000000
E{
0000000000
0000000000
0000000000
0000000000
0000000000
0000000000
0000000000
0000000000
0010101000
0000000000

