STRESS TEST
W=15
H=15
M{
/////*//*******
///////*/******
/*///////*/**//
///*///////////
/*/////////////
/////////*/////
/*/*///////////
//////*////////
/*///////////*/
///*////*//*///
//*/##//###*///
/*/##/////#*///
/*##///**//##*/
*##/////////#*/
*##/*//@/*//##*
F{
010100000000100
000000010000010
000000000000000
000000000000000
000000000000000
000000000000000
000000000000000
000000000000000
000000000000000
000000000000000
000000000000000
000000000000000
000000000000000
000000000000000
000000000000000
E{
000000000000000
000000000000000
000000000000000
000000000000000
000000000000000
000000000000000
000000000000000
000000000000000
000000000000000
000000000000000
000000000000000
000000010000000
000001000100000
000000000000000
000010100000000

