MAP ONE
W=10
H=10
M{
***///////
*#*/##////
***###////
***/#///**
/*/////*//
//***/*///
///****///
///##/////
//###/*///
//*@#//**/
F{
0000000001
0000000000
0000000000
0000000000
0000000000
0000000000
0000000000
0000000000
0000000000
0000000000
E{
0000000000
0000000000
0000000000
0000000000
0000000000
0000000000
0000000000
0010000000
0000000000
1000000000


