STRESS TEST
W=25
H=25
M{
//*///#**///*//*/////*///
#/*#**////#///*/*/*#*////
//#////**##////*/###/*///
#/*/#*//*/*///*/*/*/*//#/
#/*#**////#///*/*/*#*//#/
#/*///#**///*//*/////*/#/
//*#**////#///*/*/*#*////
//#////**##////*/###/*///
//*/#*//*/*///*/*/*/*////
//*#**////#///*/*/*#*////
//*///#**///*//*/////*///
#/*#**////#///*/*/*#*////
//#////**##////*/###/*///
//*/#*//*/*///*/*/*/*////
//*#**////#///*/*/*#*////
//*///#**///*//*/////*///
//*#**////#///*/*/*#*////
//#////**##////*/###/*///
//*/#*//*/*///*/*/*/*////
//*#**////#///*/*/*#*////
//*///#**///*//*/////*///
//*#**////#///*/*/*#*////
//#////**##////*/###/*///
//*/#*//*/*///*/*/*/*////
@/*#**////#///*/*/*#*////
F{
0000000000000000000000111
0000000000000000000000111
0000000000000000000000111
0000000000000000000000000
0000000000000000000000000
0000000000000000000000000
0000000000000000000000000
0000000000000000000000000
0000000000000000000000000
0000000000000000000000000
0000000000000000000000000
0000000000000000000000000
0000000000000000000000000
0000000000000000000000000
0000000000000000000000000
0000000000000000000000000
0000000000000000000000000
0000000000000000000000000
0000000000000000000000000
0000000000000000000000000
0000000000000000000000000
0000000000000000000000000
0000000000000000000000000
0000000000000000000000000
0000000000000000000000000
E{
0000000000000000000000000
0000000000000000000000000
0000000000000000000000000
0000000000000000000000000
0000000000000000000000000
0000000000000000000000000
0000000000000000000000000
0000000000000000000000000
0000000000000000000000000
0000000000000000000000000
0000000000000000000000000
0000000000000000000000000
0000000000000000000000000
0000000000000000000000000
0000000000000000000000000
0000000000000000000000000
0000000000000000000000000
0000000000000000000000000
0000000000000000000000000
0000000000000000000000000
1100000000000000000000000
1100000000000000000000000
1100000000000000000000000
1100000000000000000000000
0100000000000000000000000

